NO ./textures/bricksx64_bordered.png

SO ./textures/bricksx64_bordered.png WE ./textures/bricksx64_bordered.png

  EA   ./textures/bricksx64_bordered.png

F 220,100, 100C 220,100,  0

  
111111111111111111111111111111111
100000000000000000000000000000001
100000000000000000000000000000001
100000000000000000000000000000001
10000000000000000W000000000000001
100000000000000000000000000000001
100000000000000000000000000000001
100000000000000000000000000000001
100000000000000000000000000000001
100000000000000000000000000000001
100000000000000000000000000000001
100000000000000000000000000000001
111111111111111111111111111111111
