NO ./textures/64x64_tiles/Green_Wall_Rocks_64x64.png
SO ./textures/bricksx64.png
EA ./textures/64x64_tiles/Dirty_Mossy_Tiles_64x64.png
WE ./textures/64x64_tiles/Dehydrated_Earth_64x64.png

F 0,130,30 C 220,249,249

  
111111111111111111111111111111111
100001110000000000001110000000001
100001100000000001000000000010001
10000110000000100000011111111111
100001000000001000000000000000001
100001000111101000001111111111111
100000000000000000000000000000001
100000000000011111101000000100001
100000000000000001001111111110001
10000E000010000111111000000010001
100000000000000000000000010000001
100000000000000000000000010000001
111111111111111111111111111111111
